#############################
#000000000000000000000000000#
#0000r0000000r000000000000r0#
#000000000000000000000000000#
#00000000000000000000r000000#
#000000000#00000000000000000#
#000000000000000000000000000#
#000000000000000000000000000#
#000000b0000000000000#000000#
#00000000000000000000#000000#
#000000000000000000000000000#
#############################